NO  ./img/walls/brick.xpm
    SO   ./img/walls/wall.xpm
WE   ./img/walls/crate.xpm
EA    ./img/walls/grass.xpm



        F    80,100,0
               C        0,255,255





        1111111111111111111111111
        1000000000110000000000001
        1011000001110000000000001
        1001000000000000000000001
111111111011000001110000000000001
10000000001100000111D11111D111111
11110111111111D11100000010001
111101111 1111011101010010001
1100000011010101110000001Z001
1000Z000000000001100000010001
10000000000000001101010010001
11000001110101011111011110N0111
11110111 1110101 101111010001
11111111 1111111 111111111111
